LualtekRAKRUI	KEYWORD1
getBatteryVoltage	KEYWORD2
getBatteryVoltage_10x	KEYWORD2
getUplinkInterval	KEYWORD2
handleChangeDutyCycle	KEYWORD2
join	KEYWORD2
onDownlinkReceived	KEYWORD2
send	KEYWORD2
setClass	KEYWORD2
setup	KEYWORD2
setupTimers	KEYWORD2
SmartFlash	KEYWORD1
begin	KEYWORD2
getCO2AltitudeIndex	KEYWORD2
getCO2MeasurementDelayIndex	KEYWORD2
getUplinkIntervalIndex	KEYWORD2
saveCO2AltitudeIndex	KEYWORD2
saveCO2MeasurementDelayIndex	KEYWORD2
saveUplinkIntervalIndex	KEYWORD2
DutyCycleHandler	KEYWORD1
changeDutyCycle	KEYWORD2
